en : English 
jw : Javanese 
fy : Western Frisian 
ie : Interlingue 
is : Icelandic 
qu : Quechua 
da : Danish 
mfe : Morisyen 
no : Norwegian 
id : Indonesian 
fr : French 
sco : Scots 
ms : Malay 
tl : Tagalog 
so : Somali 
eo : Esperanto 
af : Afrikaans 
gn : Guarani 
na : Nauru 
eu : Basque 
it : Italian 
cs : Czech 
lt : Lithuanian 
nl : Dutch 
de : German 
st : Southern Sotho 
pl : Polish 
aa : Afar 
sv : Swedish 
gv : Manx 
ca : Catalan 
ia : Interlingua 
rm : Romansh 
fi : Finnish 
la : Latin 
ts : Tsonga 
mg : Malagasy 
ro : Romanian 
wo : Wolof 
tr : Turkish 
et : Estonian 
war : Waray 
es : Spanish 
kha : Khasi 
nn : Norwegian Nynorsk 
gd : Scottish Gaelic 
lb : Luxembourgish 
pt : Portuguese 
gl : Galician 
br : Breton 
zh : Chinese 
sr : Serbian 
ja : Japanese 
hu : Hungarian 
co : Corsican 
el : Greek 
uz : Uzbek 
ar : Arabic 
ga : Irish 
tk : Turkmen 
uk : Ukrainian 
ss : Swati 
zu : Zulu 
sq : Albanian 
iw : Hebrew 
hi : Hindi 
oc : Occitan 
sk : Slovak 
vi : Vietnamese 
cy : Welsh 
hr : Croatian 
sm : Samoan 
om : Oromo 
th : Thai 
bn : Bangla 
sl : Slovenian 
si : Sinhala 
lv : Latvian 
sa : Sanskrit 
sn : Shona 
fa : Persian 
fo : Faroese 
su : Sundanese 
rw : Kinyarwanda 
mi : MƒÅori 
fj : Fijian 
